0000000000000-
0210000000000-
0011000000000-
0001100000000-
0000110000000-
0000011110000-
0000000011120-
0000000000000