0000000000000-
0110000000000-
0011000000000-
0001100000000-
0000110000000-
0000011110000-
0000000011110-
0000000000000