28888888888883-
60000000000009-
11100000111009-
70111000101006-
90001101101111-
90000111000007-
90000000000009-
48888888888885